N H 0 0 N 0 0>10
1 2 0 1 N N>3
1 1 1 N 3 3>4
2 2 2 2 2 2 2>8
3 3 3 3 3 3 3>6
0 1 N 3 0 N 2>5
3 2 1 0 3 2 1>7
1 1 1 1 1 1 1>4
2 2 2 2 2 2 2>6
3 3 3 3 3 3 3>5
0 0 N 0 0 0 0>10
1 2 0 1>3
1 1 1>4
2 2 2 2 2 2 2>8
3 3 3 3 3 3 3>6
0 1 2 3 0 1 2>5
3 2 1 0 3 2 1>7
1 1 1 1 1 1 1>4
2 2 2 2 2 2 2>6
3 3 3 3 3 3 3>5
