0 0 0 0 0 0 0>8
1 2 0 1>2
1 1 1>3
2 2 2 2 2 2 2>6
3 3 3 3 3 3 3>4
0 1 2 3 0 1 2>4
3 2 1 0 3 2 1>5
1 1 1 1 1 1 1>3
2 2 2 2 2 2 2>5
3 3 3 3 3 3 3>4
0 0 0 0 0 0 0>8
1 2 0 1>2
1 1 1>3
2 2 2 2 2 2 2>6
3 3 3 3 3 3 3>4
0 1 2 3 0 1 2>4
3 2 1 0 3 2 1>5
1 1 1 1 1 1 1>3
2 2 2 2 2 2 2>5
3 3 3 3 3 3 3>4
0 0 0 0 0 0 0>8
1 2 0 1>2
1 1 1>3
2 2 2 2 2 2 2>6
3 3 3 3 3 3 3>4
0 1 2 3 0 1 2>4
3 2 1 0 3 2 1>5
1 1 1 1 1 1 1>3
2 2 2 2 2 2 2>5
3 3 3 3 3 3 3>4
