N N N N N 0 N N N N N>3
N N N N 0 0 0 N N N N>3
N N N 0 0 0 0 0 N N N>3
N N 0 0 0 0 0 0 0 N N>3
N 0 0 0 0 0 0 0 0 0 N>3
0 0 0 0 0 0 0 0 0 0 0>10
N 0 N 0 N 0 N 0 N 0 N>3
0 N 0 N 0 N 0 N 0 N 0>3
N 0 N 0 N 0 N 0 N 0 N>3
0 0 0 0 0 0 0 0 0 0 0>3
0 N N N N N N N N N 0>3
0 N N N N H N N N N 0>3
0 0 0 0 0 0 0 0 0 0 0>3
N 0 N 0 N 0 N 0 N 0 N>15
0 N N N N N N N N N 0>3
N 0 N N N N N N N 0 N>3
N N 0 N N N N N 0 N N>3
N N N 0 N N N 0 N N N>3
N N N N 0 N 0 N N N N>3
N N N N N 0 N N N N N>3
N N N N 0 N 0 N N N N>3
N N N 0 N N N 0 N N N>3
N N 0 N N N N N 0 N N>3
N 0 N N N N N N N 0 N>3
0 N N N N N N N N N 0>7
N 0 N 0 N 0 N 0 N 0 N>3
0 N 0 N 0 N 0 N 0 N 0>3
0 N 0 N 0 N 0 N 0 N 0>3
0 N 0 N 0 N 0 N 0 N 0>3
N 0 N 0 N 0 N 0 N 0 N>7
0 0 0 0 0 0 0 0 0 0 0>3
0 0 0 0 0 0 0 0 0 0 0>3
0 0 0 0 0 0 0 0 0 0 0>3
0 0 0 0 0 0 0 0 0 0 0>3
0 0 0 0 0 0 0 0 0 0 0>3
0 0 0 0 0 0 0 0 0 0 0>3
N 0 N 0 N 0 N 0 N 0 N>3
N N 0 N 0 N 0 N 0 N N>3
N N N 0 N 0 N 0 N N N>3
N N N N 0 N 0 N N N N>3
N N N N N 0 N N N N N>8
0 0 0 0 0 0 0 0 0 0 0>3
0 0 N N N N N N N 0 0>3
0 N N N N N N N N N 0>3
0 0 0 N N 0 N N 0 0 0>3
0 0 0 N 0 0 0 N 0 0 0>3
0 N N 0 0 0 0 0 N N 0>3
0 0 N N 0 0 0 0 N 0 0>3
0 0 0 0 0 0 0 0 0 0 0
