N 0 0 0 0 0 0 0 0 0 0 0 0 0 0 N >5
0 N N N 0 0 0 0 0 0 0 N N N 0 N >4
N N 1 1 1 1 1 1 1 1 1 1 1 N N N >6
1 N 1 1 1 1 N N 1 1 1 1 N 1 1 1 >4
N N N N N 1 N 1 N N 1 1 1 N N N >4
2 N N 2 2 2 N 2 N 2 N 2 2 N N 2 >6
N N N N 2 2 2 2 2 2 2 2 N N N N >5
N 2 N N N N N 2 N N N N N 2 N N >5
N N 3 3 3 3 N N 3 N N 3 3 3 N N >4
N 3 N N N 3 3 N N N 3 3 N 3 N 3 >6
N N 3 N N N N N 3 N 3 N 3 N 3 N >5
N 0 0 0 0 0 0 0 0 0 0 0 0 0 0 0 >7
0 0 0 0 N 0 N 0 N 0 N 0 0 N 0 0 >4
N 1 1 1 N 1 1 1 N 1 1 1 1 N 1 N >6
N N N 1 N N 1 N N 1 1 N 1 N N N >4
1 1 1 1 1 N 1 N 1 1 1 N 1 N 1 1 >4
N 2 2 2 2 2 2 2 2 2 2 2 2 N N N >6
N N 2 2 N N 2 N 2 N N 2 N 2 N N >5
2 N N 2 2 2 2 2 2 2 2 2 2 2 N N >4
N N 3 3 3 3 3 3 3 3 3 3 3 3 3 N >5
3 N 3 3 N N 3 3 N N 3 3 3 3 N N >4
N N 3 3 N N N N 3 N N N 3 N N 3 >6
0 N N 0 0 0 0 0 0 0 0 0 0 N 0 0 >5
0 0 0 0 0 0 0 0 0 0 0 0 0 0 0 0 >8
N 1 N 1 N 1 N 1 N 1 N 1 N 1 N 1 >6
1 N 1 N 1 N 1 N 1 N 1 N 1 N 1 N >5
N N 2 2 2 2 2 2 2 2 2 2 N 2 2 2 >7
2 N 2 N 2 2 N 2 2 N 2 2 N 2 N 2 >6
N N 3 3 3 3 3 N 3 N 3 N 3 N 3 N >5
N 3 3 N 3 3 N 3 3 N 3 3 3 N 3 3 >6
0 0 N 0 0 N 0 N N 0 0 N 0 0 0 N >5
N N N N 0 N N 0 N N N 0 N N N N >6
0 0 N N 0 N N 0 0 0 N N 0 0 0 N >7
N 1 N 1 N 1 N N N N N 1 1 N 1 1 >5
N N N N N 1 1 N 1 1 1 N N N N N >7
N N 2 N N 2 N N 2 N N 2 N 2 N N >6
N N 2 2 2 2 N N N 2 N N 2 2 N N >5
N N N N 3 N N N N N N 3 N N 3 N >7
N 0 0 0 0 0 0 0 0 0 0 0 0 0 0 0 >10
N N 0 N N N 0 N 0 N N N 0 N 0 N >6
N 1 1 N 1 N N N 1 1 N N N 1 N 1 >7
N 2 2 2 2 N 2 N 2 2 2 N 2 N 2 2 >6
N N N N N 2 N N 2 N N 2 N 2 N 2 >7
3 3 3 3 3 3 3 3 3 3 3 3 3 3 3 3 >8
3 3 N N N 3 N N N 3 3 N N 3 3 N >7
N 0 0 0 0 0 0 0 0 0 0 0 0 0 0 0
